List of WWE personnel - Wikipedia
================================= 

McMahon family
--------------

Ring name     |     Real name     |     Notes
Mr. McMahon | Vincent McMahon | Chairman,  Board of Directors,  Chief Executive Officer,  Executive Producer,  
Shane McMahon | Shane McMahon | Minority owner
Stephanie McMahon | Stephanie Levesque | Chief Brand Officer,  
Triple H | Paul Levesque | Executive Vice President,  Hall of Famer,  

Total owners: 4

Raw
---

Male wrestlers
--------------

Ring name     |     Real name     |     Notes
AJ Styles | Allen Jones | 
 Akam | Sunny Dhinsa | 
Baron Corbin | Thomas Pestock | 
Bobby Lashley | Franklin Lashley | 
Braun Strowman | Adam Scherr | 
Bray Wyatt | Windham Rotunda | 
Brock Lesnar | Brock Lesnar | Money in the Bank contract holder
Cedric Alexander | Cederick Johnson | 
 Cesaro | Claudio Castagnoli | 
Curt Hawkins | Brian Myers | 
Dash Wilder | Daniel Wheeler | WWE Raw Tag Team Champion
Drew McIntyre | Andrew Galloway IV | 
 EC3 | Michael Hutter | 
Eric Young | Jeremy Fritz | 
 Erik | Raymond Rowe | 
 Fandango | Curtis Hussey | 
Gran Metalik | None | 
Heath Slater | Heath Miller | 
 Ivar | Todd Smith | 
Jey Uso | Joshua Fatu | 
Jimmy Uso | Jonathan Fatu | 
 Kalisto | Emanuel Rodriguez | 
Karl Anderson | Chad Allegra | 
 Konnor | Ryan Parmeter | 
Lince Dorado | José Cordero | 
Lio Rush | Lionel Green | Manager of Bobby Lashley
Luke Gallows | Andrew Hankinson | 
The Miz | Michael Mizanin | 
Mojo Rawley | Dean Muhtadi | 
No Way Jose | Levis Valenzuela Jr. | 
Rey Mysterio | Óscar Gutiérrez | Inactive; shoulder injury
 Rezar | Gzim Selmani | 
 Rhyno | Terrance Gerin | 
 Ricochet | Trevor Mann | WWE United States Champion
Robert Roode | Robert Roode Jr. | 
Sami Zayn | Rami Sebei | 
Samoa Joe | Nuufolau Seanoa | 
Scott Dawson | David Harwood | WWE Raw Tag Team Champion
Seth Rollins | Colby Lopez | WWE Universal Champion
Titus O'Neil | Thaddeus Bullard Sr. | 
 Viktor | Eric Thompson | 
Zack Ryder | Matthew Cardona | 

Total owners: 42

Female wrestlers
----------------

Ring name     |     Real name     |     Notes
Alexa Bliss | Alexis Kaufman | 
Alicia Fox | Victoria Crawford | 
Becky Lynch | Rebecca Quin | WWE Raw Women's Champion
Dana Brooke | Ashley Sebera | 
Lacey Evans | Macey Estrella-Kadlec | 
 Naomi | Trinity Fatu | 
 Natalya | Natalie Neidhart-Wilson | 
Nia Jax | Savelina Fanene | Inactive; knee injuries
Nikki Cross | Nicola Glencross | 
Ronda Rousey | Ronda Rousey | Inactive; hand injury
Ruby Riott | Dori Prange | Inactive; shoulder surgery
Sarah Logan | Sarah Bridges | 
Sasha Banks | Mercedes Kaestner-Varnado | Inactive; personal reasons
 Tamina | Sarona Snuka-Polamalu | 

Total owners: 14

Other on-air personnel
-----------------------
Ring name     |     Real name     |     Notes
 Maryse | Maryse Mizanin | Manager of The MizOccasional wrestlerInactive; maternity leave
Paul Heyman | Paul Heyman | Manager of Brock LesnarExecutive Director of Raw

Total Raw Other on-air personnel: 2

SmackDown
---------

Male wrestlers
--------------
Aiden English | Matthew Rehwoldt | Also a color commentator on 205 Live
Aleister Black | Tom Budgen | 
 Ali | Adeel Alam | 
 Andrade | Manuel Andrade Oropeza | 
Apollo Crews | Sesugh Uhaa | 
Big E | Ettore Ewen | 
Big Show | Paul Wight II | 
Bo Dallas | Taylor Rotunda | 
Buddy Murphy | Matthew Adams | 
Chad Gable | Charles Betts | 
Curtis Axel | Joseph Hennig | 
Daniel Bryan | Bryan Danielson | WWE SmackDown Tag Team Champion
Dolph Ziggler | Nicholas Nemeth | 
 Elias | Jeffrey Sciullo | 
Epico Colon | Orlando Colón | 
Finn Bálor | Fergal Devitt | WWE Intercontinental Champion
 Harper | Jonathan Huber | 
Jeff Hardy | Jeffrey Hardy | Inactive; knee injury
Jinder Mahal | Yuvraj Dhesi | Inactive; knee injury
Kevin Owens | Kevin Steen | 
Kofi Kingston | Kofi Sarkodie-Mensah | WWE Champion
Lars Sullivan | Dylan Miley | Inactive; knee injury
Matt Hardy | Matthew Hardy | 
 Otis | Nikola Bogojevic | 
Primo Colon | Edwin Colón | 
 R-Truth | Ronnie Killings | WWE 24/7 Champion
Randy Orton | Randal Orton | 
Roman Reigns | Leati Anoa'i | 
 Rowan | Joseph Ruud | WWE SmackDown Tag Team Champion
 Rusev | Miroslav Barnyashev | 
 Sheamus | Stephen Farrelly | 
Shelton Benjamin | Shelton Benjamin | 
Shinsuke Nakamura | Shinsuke Nakamura | 
Sin Cara | Jorge Arias | 
 Tucker | Levi Cooper | 
Xavier Woods | Austin Watson | 

Total SmackDown Male: 36

Female wrestlers
----------------
 Asuka | Kanako Urai | 
 Bayley | Pamela Martinez | WWE SmackDown Women's Champion
Billie Kay | Jessica McKay | WWE Women's Tag Team Champion
 Carmella | Leah Van Dale | Manager
Charlotte Flair | Ashley Fliehr | 
Ember Moon | Adrienne Reese | 
Kairi Sane | Kaori Housako | 
 Lana | Catherine Perry | Manager of Rusev and Shinsuke Nakamura
Liv Morgan | Gionna Daddio | 
Mandy Rose | Amanda Saccomanno | 
Mickie James | Mickie James-Aldis | Inactive; knee injury
Peyton Royce | Cassie McIntosh | WWE Women's Tag Team Champion
Sonya Deville | Daria Berenato | 
Zelina Vega | Thea Trinidad | Manager of Andrade

Total SmackDown Female: 14

Other on-air personnel
-----------------------
Ring name     |     Real name     |     Notes
 Eric Bischoff | Eric Bischoff | Executive Director of SmackDown
 Paige | Saraya-Jade Bevis | Manager of Asuka and Kairi Sane

Total Smackdown on-air Personnel: 2

205 Live
--------
Male wrestlers
--------------
Akira Tozawa | Akira Tozawa | 
Ariya Daivari | Ariya Daivari | 
The Brian Kendrick | Brian Kendrick | 
Drew Gulak | Drew Gulak | WWE Cruiserweight Champion
Gentleman Jack Gallagher | Oliver Claffey | 
Humberto Carrillo | None | 
Mike Kanellis | Michael Bennett | 
Oney Lorcan | Christopher Girard | 
Samir Singh | Harvinder Sihra | 
Sunil Singh | Gurvinder Sihra | 
Tony Nese | Anthony Nese | 

Total Live Male: 11

Other on-air personnel
-----------------------
Ring name     |     Real name     |     Notes
Drake Maverick | James Curtin | General Manager
Maria Kanellis | Mary Kanellis-Bennett | Manager of Mike KanellisOccasional wrestler

Total Live on-air Personnel: 2

NXT
---
Male wrestlers
--------------
Ring name     |     Real name     |     Notes
Adam Cole | Austin Jenkins | NXT Champion
Angel Garza | Humberto Garza Solano | 
Angelo Dawkins | Gary Gordon | NXT Tag Team Champion
Bobby Fish | Robert Fish | 
Cezar Bononi | Cezar Bononi | 
Damian Priest | Luis Martínez | 
Danny Burch | Martin Harris | 
Dominik Dijakovic | Christopher Dijak | Inactive; knee injury
Jaxson Ryker | Chad Lail | 
Joaquin Wilde | Michael Paris | 
Johnny Gargano | John Gargano | 
Keith Lee | Keith Lee | 
Killian Dain | Damian Mackle | 
Kona Reeves | Noah Pang-Potjes | 
Kyle O'Reilly | Kyle Greenwood | 
 Kushida | Yujiro Kushida | 
Mansoor | Mansoor Al-Shehail | 
Matt Riddle | Matthew Riddle | 
Montez Ford | Kenneth Crawford | NXT Tag Team Champion
Raul Mendoza | Raúl Mendoza | 
Riddick Moss | Michael Rallis | 
Roderick Strong | Christopher Lindsey | 
Shane Thorne | Shane Veryzer | 
[282] | Steven Kupryk | 
Tino Sabbatelli | Sabatino Piscitelli | Inactive; torn pectoral muscle
Tommaso Ciampa | Tommaso Whitney | Inactive; neck injury
Tyler Breeze | Mattias Clement | 
Velveteen Dream | Patrick Clark Jr. | NXT North American Champion
Wesley Blake | Cory Weston | 

Total Nxt Male: 29

Female wrestlers
----------------
Ring name     |     Real name     |     Notes
 Aliyah | Nhooph Al-Areebi | 
Bianca Belair | Bianca Blair | 
Candice LeRae | Candice Gargano | 
Dakota Kai | Cheree Crowley | Inactive; torn ACL
Deonna Purrazzo | Deonna Purrazzo | 
Io Shirai | Masami Odate | 
Jessamyn Duke | Jessamyn Duke | 
Kacy Catanzaro | Kacy Catanzaro | 
[307] | Marina Shafir | 
Mia Yim | Stephanie Bell | 
Shayna Baszler | Shayna Baszler | NXT Women's Champion
Taynara Conti | Taynara Melo de Carvalho | 
Vanessa Borne | Danielle Kamela | 
Xia Li | Zhao Xia | 

Total Nxt Female: 14

Other on-air personnel
-----------------------
Ring name     |     Real name     |     Notes
William Regal | Darren Matthews | General Manager of NXTProducerTalent scoutDirector of Talent Development

Total Nxt on-air Personnel: 1

NXT UK
------
Male wrestlers
--------------
Ring name     |     Real name     |     Notes
Alexander Wolfe | Axel Tischer | 
[323] | Bilal Ansari | 
[325] | Ashton Smith | 
Dave Mastiff | David Minton | 
Eddie Dennis | Eddie Dennis | 
Fabian Aichner | Fabian Aichner | Also appears on NXT
Flash Morgan Webster | Gavin Watkins | 
Ilja Dragunov | Ilja Rukober | 
James Drake | James Dowell | NXT UK Tag Team Champion
Joe Coffey | Joseph Coffey | ICW Zero-G Champion
Jordan Devlin | Jordan Devlin | 
Joseph Conners | Joseph Buckton | 
Kassius Ohno | Chris Spradlin | 
Kenny Williams | Alan Niddrie | 
 Ligero | Simon Musk | 
Marcel Barthel | Marcel Barthel | Also appears on NXT
Mark Andrews | Mark Andrews | 
Mark Coffey | Mark Coffey | 
Noam Dar | Noam Dar | 205 Live
Pete Dunne | Peter England | 
 Primate | Jay Melrose | 
[349] | Samuel Gradwell | 
[351] | Ross Cooke | 
Travis Banks | Travis Bligh | 
Trent Seven | Benjamin Webb | 
Tyler Bate | Tyler Bate | 
[323] | Thomas Clifford | 
 Walter | Walter Hahn | WWE United Kingdom Champion
[359] | Michael Hitchman | 
 Wolfgang | Barry Young | 
Zack Gibson | Jack Rea | NXT UK Tag Team Champion

Total Nxt UK Male: 31

Female wrestlers
----------------
Ring name     |     Real name     |     Notes
[363] | Courtney Stewart | 
Jazzy Gabert | Marie Gabert | 
 Jinny | Jinny Sandhú | 
Kay Lee Ray | Kayleigh Rae | 
Killer Kelly | Raquel Lourenço | 
[368] | Samantha Allen | 
Piper Niven | Kimberly Benson | 
Rhea Ripley | Demi Bennett | 
Toni Storm | Toni Rossall | NXT UK Women's Champion
Xia Brookside | Xia Henderson | 

Total Nxt UK Female: 10

Other on-air personnel
-----------------------
Ring name     |     Real name     |     Notes
Johnny Saint | John Miller | General Manager of NXT UK
[378] | None | Assistant to the General Manager of NXT UKOccasional wrestler

Total Nxt UK on-air Personnel: 2

Unassigned wrestlers
--------------------
Ring name     |     Real name     |     Notes
John Cena | John Cena | 
 Kane | Glenn Jacobs | 
The Undertaker | Mark Calaway | 

Total Unassigned wrestlers: 3

Performance Center recruits
---------------------------
U.S. Performance Center recruits
--------------------------------
Male wrestlers
--------------
Ring name     |     Real name     |     Notes
Arturo Ruas | Adrian Jaoude | 
 Babatunde | Babatunde Aiyegbusi | 
Boa | Yanbo Wang | 
Brendan Vink | Brendan Vink | 
Brennan Williams | Brennan Williams | 
Bronson Reed |  Jermaine Haley | 
Cal Bloom | Cal Bloom | 
Cameron Grimes | Trevor Caddell | 
Daniel Vidot | Daniel Vidot | 
Denzel Dejournette | Denzel Dejournette | 
Dexter Lumis | Samuel Shaw | 
Dorian Mak | Daniel Matha | 
Faisal Kurdi | Faisal Kurdi | 
Hussain Aldagal | Hussain Aldagal | 
Isaiah Scott | Stephon Strickland | 
Jeet Rama | Satender Dagar | 
Jeff Parker | Jeffrey Parker | 
Jordan Myles | Albert Hardie Jr. | 
Jordan Omogbehin | Jordan Omogbehin | 
Malcolm Bivens | Courtenay Moore | 
Mars Wang | Wang Xiaolongl | 
Matt Lee | Matthew Lee | 
Mohamed Fahim | Mohamed Abdelfattah | 
Nick Comoroto | Nicholas Comoroto | 
Omari Palmer | Omari Palmer | 
Ridge Holland | Luke Menzies | 
Rik Bugez | Eric Bugenhagen | 
Rinku Singh | Rinku Rajput | 
Robert Strauss | Robert Strauss | 
Rocky | Yifeng Yuxiang | 
Saurav Gurjar | Saurav Gurjar | 

Total Performance Center Recruits US Male: 31

Female wrestlers
----------------
Ring name     |     Real name     |     Notes
Chelsea Green | Chelsea Green | 
Jessi Kamea | Jessica Elaban | 
Karen Q | Karen Yu | 
Kavita Devi | Kavita Dalal | 
Lacey Lane | Lacey Lane | 
MJ Jenkins | Monique Williams-Jenkins | 
Rachel Evers | Rachael Ellering | 
Reina González | Victoria Gonzalez | 
Tegan Nox | Steffanie Newell | Inactive; leg injury

Total Performance Center Recruits US Female: 9

U.K. Performance Center recruits
--------------------------------
Male wrestler
--------------
Ring name     |     Real name     |     Notes
Jack Starz | Unknown | 
Oliver Carter | Oliver Sauter | 

Total Performance Center Recruits UK Male: 2

Refrees
-------
Ring name     |     Real name     |     Notes
Chad Patton | Chad Patton | Raw
Charles Robinson | Charles Robinson | SmackDown
Chris Sharpe | Chris Sharpe | NXT UK
D.A. Brewer | Antrone Brewer | NXT
Dan Engler | Daniel Engler | Raw
Danilo Anfibio | Danilo Anfibio | SmackDown
Darrick Moore | Darrick Moore | Raw
Darryl Sharma | Darryl Sharma | NXT
Drake Wuertz | Drake Wuertz | NXTSenior refereeNXT UK
Eddie Orengo | Eddie Orengo | NXTNXT UK
Jason Ayers | Jason Ayers | SmackDown
Jessika Carr | Jessika Heiser | NXT
Joel Allen | Joel Allen | NXT UK
John Cone | John Cone | RawSenior referee
Mike Chioda | Michael Chioda | SmackDownSenior referee
Rod Zapata | Robert Vista | Raw
Ryan Tran | Brian Nguyen | SmackDown
Sean McLaughlin | Sean McLaughlin | NXT UK
Shawn Bennett | Matthew Bennett | Raw
Tom Castor | Thomas Castor | NXT

Total Refree Count: 20

Broadcast team
--------------
Ring name     |     Real name     |     Notes
Alicia Taylor | Alicia Warrington | Ring announcerBackstage interviewer
Andy Shepherd | Andy Shepherd | Ring announcer
Beth Phoenix | Elizabeth Copeland | Commentator on NXT
Booker T | Robert Huffman | Pre-show analyst for pay-per-views
Byron Saxton | Bryan Kelly | Commentator
Carlos Cabrera | Carlos Cabrera | Raw
Carsten Schaefer | Carsten Schaefer | German-language lead commentator on pay-per-views
Cathy Kelley | Catherine Kelley | Afterburn
Charly Caruso | Charly Arnolt | Backstage interviewerHost of Marquee MatchesCo-host of This Week in WWENarrator for WWE Music Power 10
 Christian | William Reso | Co-host of The Edge and Christian Show That Totally Reeks of Awesomeness
Christophe Agius | Christophe Agius | French-language commentator on Raw and pay-per-views
Corey Graves | Matthew Polinsky | Color commentator on Raw, SmackDown Live, and pay-per-viewsCo-host of Experience
David Otunga | David Otunga Sr. | Pre-show analyst for pay-per-views, occasional commentator most recently on Main Event
Dennis Arnell | Dennis McCamery | AnnouncerBackstage interviewer
 Edge | Adam Copeland | Co-host of The Edge and Christian Show That Totally Reeks of Awesomeness
Faisal Almughaisib | Faisal Almughaisib | Arabic-language commentator on pay-per-views
 Funaki | Shoichi Funaki | Japanese-language color commentator on pay-per-viewsJapanese-language host of This Week in WWE
Greg Hamilton | Greg Hutson | Ring announcer
Holger Boschen | Holger Boschen | German-language commentator on pay-per-views
Jerry Lawler | Jerry Lawler | Pre-show analyst for pay-per-viewsHall of Famer
Jerry Soto | Jerry Soto | Spanish-language color commentator on Raw, SmackDown Live and pay-per-viewsCo-host of WWE en Español
Jimena Sánchez | Jimena Sánchez | Co-host of WWE Saturday Night
 JoJo | Joseann Offerman | Ring announcerInactive; maternity leave
Jonathan Coachman | Jonathan Coachman | Host of pay-per-views pre-shows
Jude Aldajani | Jude Aldajani | Arabic-language commentator on pay-per-views
Kayla Braxton | Kayla Becker | Ring announcerBackstage interviewer
Madonna Tixeira | Madonna Tixeira | Co-host of WWE Sunday Dhamaal
Marcelo Rodríguez | Marcelo Rodríguez Laprea | Spanish-language color commentator on Raw, SmackDown Live and pay-per-viewsCo-host of WWE en Español
Marco Alfaro | Marco Alfaro | Portuguese-language commentator on pay-per-views
Mauro Ranallo | Mauro Ranallo | NXT
Meng Ai | Meng Ai | Mandarin-language commentator on pay-per-views
Michael Cole | Sean Coulthard | Lead commentator on Raw and pay-per-views
Mike Rome | Austin Romero | Ring announcerBackstage interviewer
Moein Al Bastaki | Moein Al Bastaki | Co-host of Wal3ooha
Moti Margolin | Moti Margolin | Russian-language commentator on pay-per-views
Nathalie Mamo | Nathalie Mamo | Co-host of Wal3ooha
Nigel McGuinness | Steven Haworth | Color commentator on NXT, NXT UK and 205 Live
Obaid Kadwani | Obaid Kadwani | Hindi-language commentator on pay-per-views
Pat McAfee | Patrick McAfee | Pre-show analyst for NXT TakeOver specials
Peter Rosenberg | Peter Rosenberg | Pre-show analyst for pay-per-viewsHost of Superstar Superfan
Philippe Chéreau | Philippe Chéreau | French-language commentator on Raw and pay-per-views
Radzi Chinyanganya | Radzi Chinyanganya | Backstage interviewer
Raymond Rougeau | Raymond Rougeau | French-language commentator on pay-per-views
Renee Young | Renee Paquette | Vintage
Rob Schamberger | Rob Schamberger | Host of Canvas 2 Canvas
Roberto Figueroa | Roberto Figueroa | Portuguese-language commentator on pay-per-views
Ryan Pappolla | Ryan Pappolla | Co-host of WWE Now
Salil Acharya | Salil Acharya | Co-host of WWE Sunday Dhamaal
Sam Roberts | Samuel Roberts | Pre-show analyst for pay-per-views
Sarah Schreiber | Sarah Schreiber | Backstage interviewer
Scott Stanford | Scott Stanford | Bottom Line
Sean Deng | Sean Deng | Mandarin-language commentator on pay-per-views
Sebastian Hackl | Sebastian Hackl | German-language commentator on pay-per-views
She Sardar | She Sardar | Hindi-language commentator on pay-per-views
Shun Yamaguchi | Shun Yamaguchi | Japanese-language commentator on pay-per-views
Sultan Alharbi | Sultan Alharbi | Arabic-language commentator on pay-per-views
Tom Phillips | Thomas Hannifan | Lead commentator on SmackDown Live and pay-per-viewsNarrator for Power Rankings
Vero Rodríguez | Verónica Rodríguez | Co-host of WWE Saturday Night
Vic Joseph | Vic Travagliante | Lead commentator on NXT UK and 205 Live
Zhan Pomerantsev | Zhan Pomerantsev | Russian-language commentator on pay-per-views

Total Broadcast team Count: 60

Off-screen personnel
--------------------
Ambassadors
-----------
Ring name     |     Real name     |     Notes
Bob Backlund | Robert Backlund | Hall of Famer
Brie Bella | Brianna Danielson | 
Eve Torres | Eve Gracie | 
John "Bradshaw" Layfield | John Layfield | 
Maria Menounos | Maria Menounos | 
Nikki Bella | Stephanie Garcia-Colace | 
Ric Flair | Richard Fliehr | Hall of Famer
Ricky Steamboat | Richard Blood Sr. | Hall of Famer
Sgt. Slaughter | Robert Remus | Hall of Famer
 Sting | Steve Borden | Hall of Famer
Superstar Billy Graham | Eldridge Coleman | Hall of Famer
 Tatanka | Chris Chavis | 
Tatsumi Fujinami | Tatsumi Fujinami | Hall of Famer

Total Ambassadors Count: 13

Backstage personnel
-------------------
Ring name     |     Real name     |     Notes
AJ Patterson | AJ Patterson | Lighting technician
Chris Amann | Christopher Amann | Senior ringside physician
Ciro Scotto-D'Antuono | Ciro Scotto-D'Antuono | pyrotechnician
Dustin Wallace | Dustin Wallace | Coordinating road producer
Ellis Edwards | Ellis Edwards | Stunt coordinator
Eric Bischoff | Eric Bischoff | Executive Director of SmackDown
Gabe Sapolsky | Gabriel Sapolsky | Consultant
Howard Finkel | Howard Finkel | Occasional ring announcerInterviewer for WWE.com programsChief statisticianHall of Famer
James McEvoy | James McEvoy | International digital and sponsorship director
Jennifer Hagopian | Jennifer Hagopian | Catering crew chief
Jet Prickett | Jet Prickett | Stage manager
Julie Youngberg | Julie Youngberg | Seamstress
Lex Luger | Lawrence Pfohl | Wellness counselor
Mika Rotunda | Mika Rotunda | Production assistant
Mikaze | Sarath Ton | Seamstress
Nicholas Daw | Nicholas Daw | Ring Manager
Stephen Daquino | Stephen Daquino | Ringside physician
Tom Stewart | Thomas Stewart | Camera operator
Tony Chimel | Anthony Chimel | Ring crew chiefOccasional ring announcer

Total Backstage personnel Count: 19

Creative team
-------------
Ring name     |     Real name     |     Notes
Bruce Prichard | Bruce Prichard | Senior Vice President
Dana Warrior | Dana Warrior | 
Dewey Foley | Dewey Foley | Creative assistant
Ed Koskey | Edward Koskey | Raw
Jonathan Baeckstrom | Jonathan Baeckstrom | Lead writer for 205 Live
Joseph Belcastro | Joseph Belcastro | Lead writer for NXTPromo trainer
Ranjin Singh | David Kapoor | Senior VP of Creative
Road Dogg | Brian James | Hall of Famer
Ryan Ward | Ryan Ward | SmackDown Live
Stephen Guerrieri | Stephen Guerrieri | Lead writer for SmackDown Live

Total Creative team Count: 10

Music department
----------------
Name       |       Notes
John Alicastro | Composer
Michael Lauri | Composer
Neil Lawi | WWE Music Group
Josiah Williams | On-Air Digital Talent

Total Music Department Count: 4

Producers
---------
Ring name     |     Real name     |     Notes
Adam Pearce | Adam Pearce | 
Billy Kidman | Peter Gruner Jr. | 
Chris Parks | Christopher Parks | 
D-Von Dudley | Devon Hughes | Hall of Famer
Fit Finlay | David Finlay Jr. | 
Glen Joseph | Glen Robinson | NXT UK
Gregory Helms | Gregory Helms | 
Irwin R. Schyster | Lawrence Rotunda | 
James Long | James Long | 
Jamie Noble | James Gibson | 
Jason Jordan | Nathan Everhart | 
Jeff Jarrett | Jeffrey Jarrett | Hall of Famer
Jeremy Borash | Jeremy Borash | 
Jim Smallman | James Smallman | Producer for NXT UK
John Gaburick | John Gaburick | 
John Laurinaitis | John Laurinaitis | 
Kurt Angle | Kurt Angle | Hall of Famer
Mark Henry | Mark Henry | Hall of Famer
Michael Hayes | Michael Seitz | Senior producerHall of Famer
Norman Smiley | Norman Smiley | Performance Center trainer/coach
Pat Patterson | Pat Patterson | Hall of Famer
Sara Amato | Sara Amato | WWE Performance Center assistant head trainer
Sarah Stock | Sarah Stock | Trainer at the WWE Performance Center
Scott Armstrong | Joseph James Jr. | 
Shawn Daivari | Dara Daivari | 
Sonjay Dutt | Retesh Bhalla | 
Steve Corino | Steven Corino | 
Tyson Kidd | Theodore Wilson | 

Total Producers Count: 28

WWE Performance Center staff
----------------------------
Ring name     |     Real name     |     Notes
Brian Duncan | Brian Duncan | Head athletic trainer
Canyon Ceman | Canyon Ceman | Senior Director of Talent Development
David Bailey | David Bailey | WWE Performance Center
Gerald Brisco | Gerald Brisco | Hall of Famer
Hartley Jackson | Hartley Jackson | TrainerAssistant coach
Johnny Moss | John Mossop | TrainerAssistant coach
Matt Bloom | Matthew Bloom | Head coach
Robbie Brookside | Robert Brooks | TrainerAssistant coach
Ryan Katz | Ryan Katz | Associate producerPromo trainer
Scott Garland | Scott Garland | TrainerAssistant coach
Sean Hayes | Sean Hayes | Strength and conditioning coach
Serena Deeb | Serena Deeb | TrainerAssistant coach
Shawn Michaels | Michael Hickenbottom | TrainerHall of Famer
Tanner Robinson | Tanner Robinson | Assistant strength and conditioning coach
Tara Halaby | Tara Halaby | Athletic trainerPhysical therapist
Terry Taylor | Paul Taylor III | TrainerAssistant coach

Total WWE Performance Center Staff Count: 16

WWE Corporate staff
-------------------
Board of Directors and executive officers
-----------------------------------------
Name      |      Notes
Basil DeVito | Board of Directors
 | Chief Marketing & Communications Officer
David Kenin | Member of the Board of Directors
Frank Riddick III | Member of the Board of Directors
George Barrios | Co-PresidentExecutive officerMember of the Board of Directors
Jeffrey Speed | Member of the Board of Directors
John Brody | Executive Vice President, Global Sales & PartnershipsSenior Vice President, International
Joseph Perkins | Member of the Board of Directors
Kevin Dunn | Member of the Board of Directors
Laura Brevetti | Senior Vice President, General Counsel and Secretary
Laureen Ong | Member of the Board of Directors
Lauren Dienes-Middlen | General Counsel and Executive Vice President, Intellectual Property
Michelle D. Wilson | Co-PresidentExecutive officerMember of the Board of Directors
Patricia Gottesman | Member of the Board of Directors
Rajan Mehta | Chief technology officer
Stuart Goldfarb | Member of the Board of Directors

Total Corporate staff count: 16

Senior Management
-----------------
Barry McMullin | Senior Vice President, Sales and Partnership Marketing
Emilio Revelo | Director, Content Media Distribution International
Henry Jacob | London
Joey Villa | Senior Publicist Manager
Lance McConomy | Senior Director of Broadcast Operations
Michael Weitzschnitz | Senior Vice President, Investor Relations and Financial Planning
Monty Sarhan | Senior Vice President, General Counsel and Secretary
Patrick Talty | Live Events
 | Senior Vice President, Consumer Products
Shane Davis | Coordinator, Community Relations
Sheetesh Srivastava | Vice President and General Manager – India
Tara Carraro | Vice President, Corporate Communications

Total Senior Management count: 12

